0 40 10
........................................
........................................
........................................
...............C........................
..........C...###.............C.........
..............#B#.............#.........
......M.......###.......P........L......
.............................###........
.S......E.....T.....C....E...........F.
########################################
